NO ./assets/images/north.xpm
SO ./assets/images/south.xpm
WE ./assets/images/west.xpm
EA ./assets/images/east.xpm
F 184,113,39
C 51,198,227

        1111111111111111111111111
       11000001000110000000000001
        101100000111000000N000001
        1001000000D00000000001111
111111  101100011111D1111111111 
1111011 11111101 100000010001    
11110111111111D1 101010010001
11000000110101011100000010001
10001000000000000000000D00011
10000100000000011101010010001
1100000111010101 111011110001
11110111 1110101 101111010001
11111111 1111111 111111111111
